     NO ./textures/door.png
SO ./textures/door2.png
       WE ./textures/door3.png
EA        ./textures/door4.png

F                                  255,255,255


C 255,255,255


     111111
   1100000011
  100000000001 
 10000000000001
 10000000000001
1000000000000001
1000000000000001
1000000N00000001
1000000000000001
1000000000000001
1000000000000001
 10000000000001
 10000000000001
  100000000001
   1100000011
     111111