     NO ./textures/door.png
SO ./textures/door2.png
       WE ./textures/door3.png
EA        ./textures/door4.png

F                                  255,255,255


C 255,255,255

11111111
10000001
10000001
11111101
10000001
11011111
10000001
10000001
11111011
10000001
100N0001
11111111
