     NO ./textures/door.png
SO ./textures/door2.png
       WE ./textures/door3.png
EA        ./textures/door4.png

F                                  255,255,255


C 255,255,255

11111111
100Q0001
10000001
111111C1
10000001
11C11111
10000001
10000001
11111C11
10000001
100N0001
11111111