     NO ./textures/pf9.png
SO ./textures/pf3.png
       WE ./textures/pf5.png
EA        ./textures/pf7.png

F                                  220,100,0


C 225,30,0

11111111111111111111111111111111                  
10000000000000000000000000000001
10000000000000000000000000000001
10000000000000000000000000000001
10000000000000000000000000000001
10000000000000000000000000000001
10000000000000000000000000000001
10000000000000000000000000000001
10000001000000000000000001000001
10000000000000000000000000000001
10000000000000000000000000000001
10000000000000000000000000000001
10000000000000000000000000000001
10000000000000000000000000000001
10000000000000001000000000000001
10000000000000000000000000000001
10000000000000000000000000000001
10000000000000000000000000000001
10000000000000000000000000000001
10000000000000000000000000000001
10000000000000000000000000000001
10000000000000000000000000000001
10000000000000000000000000000001
10000000000000000000000000000001
10000000000000000000000000000001
10000000000000000000000000000001
10000000000000000000000000000001
10000000000000000000000000000001
10000000000000000000000000000001
10000000000000000000000000000001
10100000000000000000000000000001
10010101000000000000000000000001
11001101011111111000000000000001
10100001001000001000000000000001
1010110111101010100000000000001
1000000000001N100000000000000001
11111111111111111111111111111111